/Our Guy/ -> _Our Guy_
4/20 -> 4_20
6 Gorillion -> 6 Gorillion
6 Million Wasn't Enough (6MWE) -> 6 Million Wasn't Enough (6MWE)
7.59 -> 7.59
13/51 -> 13_51
131 -> 131
1143 -> 1143
1488 -> 1488
ACAB (All Cops are Bastards) -> ACAB (All Cops are Bastards)
Agenda 21 -> Agenda 21
Alt-Right and Alt-Lite -> Alt-Right and Alt-Lite
Anti-racist is a code word for anti-white/Diversity is a code word for white genocide -> Anti-racist is a code word for anti-white_Diversity is a code word for white genocide
Antifa Helicopter Ride meme -> Antifa Helicopter Ride meme
Ausländer Raus (foreigners out) -> Ausländer Raus (foreigners out)
AYAK and AKIA -> AYAK and AKIA
Bevara Sverige Svenskt (Keep Sweden Swedish) -> Bevara Sverige Svenskt (Keep Sweden Swedish)
Blood and Honour -> Blood and Honour
Blue pill, red pill, black pill, white pill -> Blue pill, red pill, black pill, white pill
Blut und Boden (Blood and Soil) -> Blut und Boden (Blood and Soil)
Boogaloo Movement flags -> Boogaloo Movement flags
Build the Wall -> Build the Wall
Canada First -> Canada First
Clown World -> Clown World
Covidisme -> Covidisme
Cuck -> Cuck
Cultural Enrichment Meme -> Cultural Enrichment Meme
Cultural Marxism -> Cultural Marxism
Day of the Rope -> Day of the Rope
Deep State -> Deep State
Deus, pátria e família (God, Country, and Family) -> Deus, pátria e família (God, Country, and Family)
Did Nothing Wrong/Hitler Did Nothing Wrong -> Did Nothing Wrong_Hitler Did Nothing Wrong
Digital Soldier -> Digital Soldier
Dindu Nuffin -> Dindu Nuffin
Echo ((( ))) -> Echo ((( )))
Ethnopluralism -> Ethnopluralism
Identitarian -> Identitarian
FAFO (Fuck Around and Find Out) -> FAFO (Fuck Around and Find Out)
Fashwave and Terrorwave -> Fashwave and Terrorwave
FCK AFA -> FCK AFA
Fourteen Words, 14 words, 14W -> Fourteen Words, 14 words, 14W
Français de souche ("Of French Origins) -> Français de souche (_Of French Origins)
Anti-Immigrant -> Anti-Immigrant
Gender Ideology -> Gender Ideology
Globalists -> Globalists
Globohomo -> Globohomo
Grand Remplacement / être grand remplacé (Great Replacement) -> Grand Remplacement _ être grand remplacé (Great Replacement)
Great Reset conspiracy theory -> Great Reset conspiracy theory
Groomer -> Groomer
GTKRWN/"Gas the K**** - Race War Now" -> GTKRWN__Gas the K____ - Race War Now_
HH (also "HH") -> HH (also _HH_)
House the Irish First -> House the Irish First
Hypergamy -> Hypergamy
I will not eat the bugs -> I will not eat the bugs
International Zionism -> International Zionism
Islamization -> Islamization
Islamo-gauchisme (Islamo-leftism) -> Islamo-gauchisme (Islamo-leftism)
It's Okay To Be White -> It's Okay To Be White
Italia agli Italiani -> Italia agli Italiani
Jogger -> Jogger
Kekistan Flag -> Kekistan Flag
La France aux Français (France for the French) -> La France aux Français (France for the French)
LGB -> LGB
Lookism -> Lookism
Love Jihad conspiracy -> Love Jihad conspiracy
Lügenpresse (Lying press) -> Lügenpresse (Lying press)
Moon Man -> Moon Man
Naming the Jew/Noticing/YKW -> Naming the Jew_Noticing_YKW
National Preference (préférence nationale) -> National Preference (préférence nationale)
New World Order -> New World Order
No Rapeugees -> No Rapeugees
Not Equal -> Not Equal
On est chez nous ("This is our home") -> On est chez nous (_This is our home_)
Orthodoxy or death! (Православие или смерть!) -> Orthodoxy or death! (Православие или смерть!)
Pepe the Frog -> Pepe the Frog
Portugal aos portugueses (Portugal for the Portuguese) -> Portugal aos portugueses (Portugal for the Portuguese)
Qu'ils retournent en Afrique (May they return to Africa) -> Qu'ils retournent en Afrique (May they return to Africa)
Qui? [Who?] -> Qui_ [Who_]
RAHOWA -> RAHOWA
Remigration -> Remigration
Remove Kebab -> Remove Kebab
Revolt Against The Modern World -> Revolt Against The Modern World
Right Wing Death Squad (RWDS) -> Right Wing Death Squad (RWDS)
Rothschilds conspiracy theory -> Rothschilds conspiracy theory
Schild & Vrienden (Shield and Friends) -> Schild & Vrienden (Shield and Friends)
Self-Deportation -> Self-Deportation
Shitskin -> Shitskin
SPQR -> SPQR
Stand Back and Stand By -> Stand Back and Stand By
Supreme Gentleman -> Supreme Gentleman
The Daily Stormer logo -> The Daily Stormer logo
The Goyim Know -> The Goyim Know
The Groyper -> The Groyper
The Jewish Question/The JQ -> The Jewish Question_The JQ
The Pit Viper sunglasses -> The Pit Viper sunglasses
Total _____ Death (T_D) -> Total _____ Death (T_D)
TradCath -> TradCath
Tudo pela Nação, nada contra a Nação (All for the Nation, nothing against the Nation) -> Tudo pela Nação, nada contra a Nação (All for the Nation, nothing against the Nation)
Ukronazism -> Ukronazism
Umvolkung / Omvolking (Repopulation) -> Umvolkung _ Omvolking (Repopulation)
Untermensch (subhuman) -> Untermensch (subhuman)
Vi ses i Finspång (See you in Finspång) -> Vi ses i Finspång (See you in Finspång)
Well Well Well -> Well Well Well
Where We Go One, We Go All (WWG1WGA) -> Where We Go One, We Go All (WWG1WGA)
White Boy Summer -> White Boy Summer
White Genocide -> White Genocide
White Lives Matter -> White Lives Matter
White Power (also "WP") -> White Power (also _WP_)
WPWW and White Pride Worldwide -> WPWW and White Pride Worldwide
You Will Not Replace Us (also "Jews Will Not Replace Us") -> You Will Not Replace Us (also _Jews Will Not Replace Us_)
You will own nothing and be happy -> You will own nothing and be happy
YWNBAW (You Will Never Be A Woman) -> YWNBAW (You Will Never Be A Woman)
Z -> Z
ZOG -> ZOG
